%%%%%%%%%%%%%%%%%%%%%%%
%$$ $$ $$ $$$ $$ $$ $$%
%      $   E   $      %
%$$$$$$R       R$$$$$$%
%                     %
% $  $ V   R   V $  $ %
%      $       $      %
%$$$$$$R   E   R$$$$$$%
%      $$$$$$$$$      %
% $ $ $         $ $ $ %
%        $ $ $        %
%                     %
%                    B%
%%%%%%%%%%%%%%%%%%%%%%%
