%%%%%%%%%%%%%%%%%%%%%%%
%R                   R%
%V     $       $     V%
%$$$$$$R       R$$$$$$%
%T                   T%
% $  $     T     $  $ %
%      $       $      %
%$$$$$$   V  V  $$$$$$%
%  V   $$$$$$$$$  V   %
% $ $ $         $ $ $ %
%  R     $ $ $    V   %
%$$$$$$         $$$$$$%
%          $         B%
%%%%%%%%%%%%%%%%%%%%%%%
